111111111111111111111111111111
10001C1000000000000000000000P1
100010100000000000000000000001
100000000000000000000000000001
100000000000000000000000000001
100000000000000000000000C00001
100000000000000000000000000001
100000000000000000000000000001
111100000000000000000000000001
1E0100000000000000000000000001
100000000000000000000000000001
100000000000000000000000000001
100000000000000000000000000001
111111111111111111111111111111
