111111111111111111111111111111
10000C0100000000000000000000P1
100011100000000000000000000001
100000000000000000000000000001
100000000000000000000000000001
100000000000000000000000C00001
100000000010000000000000000001
10000000001C000000000000000001
111100000010000000000000000001
1E0000000000000000000000000001
111111111111111111111111111111
100000000000000000000000000001
100000000000000000000C00000001
111111111111111111111111111111
