111111111111111111111111111111111111111111111111111111111111
100000000000000000000000000000000000000000000000000000000001
100000000000000000000000000000000000000000000000000000000001
1000P0000000000000000000000000000000000000000000000000000001
1000000000000000000000000000000000000000000000000000E0000001
100000000000000000000000000000000000000000000000000000000001
100000000000000000000000000000000000000000000000000000000001
111111110111111111111111111111111111111111111111111111111111
1000000000000000000000000000000C0000000000000000000000000001
111111111111111111111111111111111111111111111111111111101111
100C00000000000000000000000000000000000000000000000000000001
111111111111111111111111111111111111111111111111101111111111
100000000000000000000000000000C00000000000000000000000000001
111111111111111111111111111111111111111111111111111011111111
100000C00000000000000000000000000000000000000000000000000001
111111111111111111111111111111111111111111111111111111111111
